111111111
1000101C1
101000001
111110111
101EP00C1
111111111