111111111
11P1100C1
1010C0001
101110111
101E000C1
111111111