111111111
10P0100C1
1000C0001
101110011
101E000C1
111111111