111111111
10P0100C1
1000C0001
101110111
101E001C1
111111111