111111111
1000100C1
100000001
101110011
101E00001
111111111