11111111
10000C01
111E0001
1000P111
10C00101
11111111