11111111
100C0001
111E0001
1000P011

10C00001
11111111