11111111
10000C01
111E0001
1000P111
1Z0000C1
11111111